10
30 25

0 0 0 0 0 0 0 0 0 0 0 0 0 0 0 0 0 0 0 0 0 0 0 0 0 0 0 0 0 0 0 0 0 0 0 0 0 0 0 0 0 0 0 0 0 0 0 0 0 0 
0 0 0 -1 0 -1 0 -1 0 -1 0 -1 0 -1 0 -1 0 -1 0 -1 0 -1 0 -1 0 -1 0 -1 0 -1 0 -1 0 -1 0 -1 0 -1 0 -1 0 -1 0 -1 0 -1 0 -1 0 0 
0 0 0 -1 0 -1 0 -1 0 -1 0 -1 0 -1 0 -1 0 -1 0 -1 0 -1 0 -1 0 -1 0 -1 0 -1 0 -1 0 -1 0 -1 0 -1 0 -1 0 -1 0 -1 0 -1 0 -1 0 0 
0 0 0 -1 0 -1 0 -1 0 -1 0 -1 0 -1 0 -1 0 -1 0 -1 0 -1 0 -1 0 -1 0 -1 0 -1 0 -1 0 -1 0 -1 0 -1 0 -1 0 -1 0 -1 0 -1 0 -1 0 0 
0 0 0 -1 0 -1 0 -1 0 -1 0 -1 0 -1 0 -1 0 -1 0 -1 0 -1 0 -1 0 -1 0 -1 0 -1 0 -1 0 -1 0 -1 0 -1 0 -1 0 -1 0 -1 0 -1 0 -1 0 0 
0 0 0 -1 0 -1 0 -1 0 -1 0 -1 0 -1 0 -1 0 -1 0 -1 0 -1 0 -1 0 -1 0 -1 0 -1 0 -1 0 -1 0 -1 0 -1 0 -1 0 -1 0 -1 0 -1 0 -1 0 0 
2 0 2 0 2 0 2 0 2 0 2 0 2 0 2 0 2 0 2 0 2 0 2 0 2 0 2 0 2 0 2 -1 2 -1 2 -1 2 0 2 0 2 0 2 0 2 0 2 0 2 0 
2 0 2 0 2 0 2 0 2 0 2 0 2 0 2 0 2 0 2 0 2 0 2 0 2 0 2 0 2 0 2 -1 2 -1 2 -1 2 0 2 0 2 0 2 0 2 0 2 0 2 0 
2 0 2 0 2 0 2 0 2 0 2 0 2 0 2 0 2 0 2 0 2 0 2 0 2 0 2 0 2 0 2 -1 2 -1 2 -1 2 0 2 0 2 0 2 0 2 0 2 0 2 0 
2 0 2 -1 2 -1 2 -1 2 -1 2 -1 2 -1 2 -1 2 -1 2 -1 2 1 2 1 2 1 2 1 2 -1 2 -1 2 -1 2 -1 2 -1 2 1 2 1 2 -1 2 -1 2 -1 2 0 
2 0 2 -1 2 -1 2 -1 2 -1 2 -1 2 -1 2 -1 2 -1 2 -1 2 1 2 1 2 1 2 1 2 -1 2 -1 2 -1 2 -1 2 -1 2 1 2 1 2 -1 2 -1 2 -1 2 0 
2 0 2 -1 2 -1 2 -1 2 -1 2 -1 2 -1 2 -1 2 -1 2 -1 2 1 2 1 2 1 2 1 2 -1 2 -1 2 -1 2 -1 2 -1 2 1 2 1 2 -1 2 -1 2 -1 2 0 
2 0 2 -1 2 -1 2 -1 2 -1 2 -1 2 -1 2 -1 2 -1 2 -1 2 1 2 1 2 1 2 1 2 -1 2 -1 2 -1 2 -1 2 -1 2 1 2 1 2 -1 2 -1 2 -1 2 0 
2 0 2 -1 2 -1 2 -1 2 -1 2 -1 2 -1 2 -1 2 -1 2 -1 2 1 2 1 2 1 2 1 2 -1 2 -1 2 -1 2 -1 2 -1 2 1 2 1 2 -1 2 -1 2 -1 2 0 
2 0 2 -1 2 -1 2 -1 2 -1 2 -1 2 -1 2 -1 2 -1 2 -1 2 1 2 1 2 1 2 1 2 -1 2 -1 2 -1 2 -1 2 -1 2 1 2 1 2 -1 2 -1 2 -1 2 0 
2 0 2 -1 2 -1 2 -1 2 -1 2 -1 2 -1 2 -1 2 -1 2 -1 2 1 2 1 2 1 2 1 2 -1 2 -1 2 -1 2 -1 2 -1 2 1 2 1 2 -1 2 -1 2 -1 2 0 
2 0 2 -1 2 -1 2 -1 2 -1 2 -1 2 -1 2 -1 2 -1 2 -1 2 1 2 1 2 1 2 1 2 -1 2 -1 2 -1 2 -1 2 -1 2 1 2 1 2 -1 2 -1 2 -1 2 0 
2 0 2 -1 2 -1 2 -1 2 -1 2 -1 2 -1 2 -1 2 -1 2 -1 2 1 2 1 2 1 2 1 2 -1 2 -1 2 -1 2 -1 2 -1 2 1 2 1 2 -1 2 -1 2 -1 2 0 
2 0 2 -1 2 -1 2 -1 2 -1 2 -1 2 -1 2 -1 2 -1 2 -1 2 1 2 1 2 1 2 1 2 -1 2 -1 2 -1 2 -1 2 -1 2 1 2 1 2 -1 2 -1 2 -1 2 0 
2 0 2 -1 2 -1 2 -1 2 -1 2 -1 2 -1 2 -1 2 -1 2 -1 2 1 2 1 2 1 2 1 2 -1 2 -1 2 -1 2 -1 2 -1 2 1 2 1 2 -1 2 -1 2 -1 2 0 
2 0 2 -1 2 -1 2 -1 2 -1 2 -1 2 -1 2 -1 2 -1 2 -1 2 1 2 1 2 1 2 1 2 -1 2 -1 2 -1 2 -1 2 -1 2 1 2 1 2 -1 2 -1 2 -1 2 0 
2 0 2 -1 2 -1 2 -1 2 -1 2 -1 2 -1 2 -1 2 -1 2 -1 2 1 2 1 2 1 2 1 2 -1 2 -1 2 -1 2 -1 2 -1 2 1 2 1 2 -1 2 -1 2 -1 2 0 
2 0 2 -1 2 -1 2 -1 2 -1 2 -1 2 -1 2 -1 2 -1 2 -1 2 1 2 1 2 1 2 1 2 -1 2 -1 2 -1 2 -1 2 -1 2 1 2 1 2 -1 2 -1 2 -1 2 0 
2 0 2 0 2 0 2 0 2 0 2 0 2 0 2 0 2 0 2 0 2 0 2 0 2 0 2 0 2 0 2 -1 2 -1 2 -1 2 0 2 0 2 0 2 0 2 0 2 0 2 0 
1 0 1 0 1 0 1 0 1 0 1 0 1 0 1 0 1 0 1 0 1 0 1 0 1 0 1 0 1 0 1 -1 1 -1 1 -1 1 0 1 0 1 0 1 0 1 0 1 0 1 0 
1 0 1 0 1 0 1 0 1 0 1 0 1 0 1 0 1 0 1 0 1 0 1 0 1 0 1 0 1 0 1 -1 1 -1 1 -1 1 0 1 0 1 0 1 0 1 0 1 0 1 0 
1 0 1 -1 1 -1 1 -1 1 -1 1 -1 1 -1 1 -1 1 -1 1 -1 1 -1 1 -1 1 -1 1 -1 1 -1 1 -1 1 -1 1 -1 1 -1 1 -1 1 -1 1 -1 1 -1 1 -1 1 0 
1 0 1 -1 1 -1 1 -1 1 -1 1 -1 1 -1 1 -1 1 -1 1 -1 1 -1 1 -1 1 -1 1 -1 1 -1 1 -1 1 -1 1 -1 1 -1 1 -1 1 -1 1 -1 1 -1 1 -1 1 0 
1 0 1 -1 1 -1 1 -1 1 -1 1 -1 1 -1 1 -1 1 -1 1 -1 1 -1 1 -1 1 -1 1 -1 1 -1 1 -1 1 -1 1 -1 1 -1 1 -1 1 -1 1 -1 1 -1 1 -1 1 0 
1 0 1 0 1 0 1 0 1 0 1 0 1 0 1 0 1 0 1 0 1 0 1 0 1 0 1 0 1 0 1 0 1 0 1 0 1 0 1 0 1 0 1 0 1 0 1 0 1 0 

0 1344 192
1 640 1000
3 896 1408
4 192 1408
